






















durex




























please select your market's page below











 ae - united arab emirates




 at - austria




 au - australia




 bd - bangladesh




 be - belgium




 ca - canada




 ch - switzerland




 cl - chile




 cn - china




 co - colombia




 cr -  costa rica




 cz - czech republic




 de - deutschland




 dk - denmark




 ee- estonia




 es - spain




 fi - finland




 fr - france




 gr - greece




 gt - guatemala




 hn - honduras




 hu - hungary




 id - indonesia




 ie - ireland




 il - 	israel




 in - india




 it - italy




 jp - japan




 lv - latvia




 my - malaysia




 ng - nigeria




 ni - nicaragua




 nl - netherlands




 no - norway




 nz - new zealand




 pa - panama




 pe - peru




 ph - philippines




 pk - pakistan




 pl - polska




 pt - portugal




 ro - romania




 ru - russian federation




 se - sweden




 sg - singapore




 sv - el salvador




 th - thailand




 tr - turkiye




 ua - ukraine




 uk - united kingdom




 us - united states




 vn - vietnam




 za - south africa




















