



arcade video game coinop sales by coinopexpress

































 




last update, february 18, 2025. 




















 









          arcade video game coinop sales by coinopexpress        



 





				welcome to coinopexpress, an online website providing the
                widest range of coin operated / amusement / arcade
                / gaming / video game / and merchandise products
                at the lowest possible prices. we offer;
			

live multicurrency market prices and stock information
online ordering and tracking
live help
marketplace email reports
new product notification and much more...


















arcade game latest news & updates














 
            let’s go jungle & house of the dead 4 super deluxe motion machines! 

 



great news!!! we have let’s go jungle and the house of the dead 4 super deluxe motion machines in the process of cleaning!










other news stories


* 
brick stacker skill test prize redemption machine on hot sale!
05 jun, 2024


* 
crazy guitar hammer machine available!
21 may, 2024


* 
electronic jazz drum 2 game machine – hot sale!
08 may, 2024


* 
various styles of basketball shooting machines for sale!!!
29 mar, 2024


* 
great news the phoenix pump it up machine new arrival!
13 mar, 2024




click here for news section







 arcade game latest offers 






 

 

razing storm dx shooting game machine
$2995.00 usd          


 razing storm dx shooting game machine is an arcade light gun shooter which runs on the playstation 3 based system 357 arcade hardware. players must take on terrorists as part of the special forces unit scar in south america circa 2030. 
click here for  section 














 

 

the house of the dead 4 special
please ask          


 the house of the dead 4 special is a horror-themed light gun shooter arcade game, and a two-player attraction based on the house of the dead 4 by sega. 
click here for arcade game machines section 














 

 

tekken 6: bloodline rebellion game board
$850.00 usd          


 tekken 6: bloodline rebellion game board is a fighting game developed and published by namco, it is an updated version of tekken 6. the game board is used but in excellent condition, japanese and english mixed version, it is a complete game board, plug and play. 
click here for pcbs & kits section 














 

 

sanwa joystick (jlf-tp-8yt)
please ask          


 the official sanwa joystick (jlf-tp-8yt), used as standard in the majority of japanese made arcade cabinets. regarded as one of best joysticks around. 
click here for spare parts section 














 

 

automatic induction alcohol spray sterilizer
$43.99 usd          


 automatic induction alcohol spray sterilizer which is a avoid hand contact to prevent cross infection product. 
click here for merchandises section 




























customer login



email :

password :











  • arcade game machines 1098   • pcbs & kits 164   • spare parts 634   • merchandises 909   • total 2805  

view summary map






 





view prices in:

adp - andorran peseta
aed - u.a. emirates dirham
afn - afghanistan afgani
all - albanian leks
amd - armenian dram
ang - neth. antilles guilders
ars - argentine pesos
aud - australian dollars
awg - aruban florin
bbd - barbados dollars
bdt - bangladeshi taka
bgn - bulgarian lev
bhd - bahraini dinars
bif - burundi franc
bmd - bermudian dollars
bnd - brunei dollars
bob - bolivian boliviano
brl - brazilian reals
bsd - bahamian dollars
btn - bhutan ngultrum
bwp - botswana pula
byr - belarus roubles
bzd - belize dollar
cad - canadian dollars
chf - swiss francs
clp - chilean pesos
cny - chinese renminbi
cop - colombian pesos
crc - costa rican colon
cup - cuban pesos
cve - cape verde escudo
cyp - cypriot pound
czk - czech koruna
djf - djibouti franc
dkk - danish kroner
dop - dominican republic pesos
dzd - algerian dinar
ecs - ecuadoran sucre
eek - estonian kroon
etb - ethiopian birr
eur - european euros
fjd - fijian dollars
gbp - british pounds
gel - georgian lari
ghs - ghanaian cedis
gip - gibraltar pound
gmd - gambian dalasi
gnf - guinea franc
gtq - guatemalan quetzales
gyd - guyana dollar
hkd - hong kong dollars
hnl - honduran lempiras
hrk - croatian kuna
htg - haitian gourdes
huf - hungarian forint
idr - indonesian rupiah
ils - israeli new shekels
inr - indian rupees
irr - iranian rial
isk - icelandic krona
jmd - jamaican dollars
jod - jordanian dinar
jpy - japanese yen
kes - kenyan schillings
kgs - kyrgyzstan som
khr - kampuchean (cambodian) riel
kmf - comoros francs
krw - south korean won
kwd - kuwaiti dinar
kyd - cayman islands dollar
kzt - kazakhstan tenge
lak - laotian new kip
lbp - lebanese pound
lkr - sri lankan rupees
lrd - liberian dollar
lsl - lesotho loti
ltl - lithuanian litas
lvl - latvian lat
lyd - libyan dinar
mad - moroccan dirham
mdl - moldovian lei
mga - madagascar ariayry
mmk - myanmar kyat
mnt - mongolian tugrik
mop - macau pataca
mro - mauritanian ouguiya
mtl - maltese lira
mur - mauritius rupee
mvr - maldive rufiyaa
mwk - malawi kwachas 
mxn - mexican pesos
myr - malaysian ringgit
ngn - nigerian nairas
nic - nicaraguan cordoba
nok - norwegian kroner
npr - nepalese rupee
nzd - new zealand dollars
omr - omani rial
pab - panamanian balboas
pen - peruvian new soles
pgk - papua n. g. kina
php - philippines pesos
pkr - pakistani rupees
pln - polish zloty
pyg - paraguayan guarani
qar - qatari riyal
ron - romanian leu
rsd - serbian dinar
rub - russian rubles
rwf - rwanda franc
sbd - solomon is. dollar
scr - seychelles rupee
sdd - sudanese dinars
sek - swedish krona
sgd - singapore dollars
skk - slovakian koruna
sll - sierra leonan leone
sos - somali schilling
srd - surinam dollar
std - sao tome dobra
svc - el salvadoran colon
syp - syrian pound
szl - swaziland lilangeni
thb - thai baht
tnd - tunisian dinars
try - turkish new lira
ttd - trinidad & tobago dollars
twd - taiwanese dollars
tzs - tanzanian shilling
uah - ukrainian hryvna
ugx - ugandan shillings
usd - u.s. dollars
uyu - uruguayan pesos
uzs - uzbek som
vef - venezuelan bolivares
vnd - vietnamese dong
vuv - vanuatu vatu
xaf - french-african francs
xcd - east caribbean dollars
xpf - french-pacific francs
zar - south african rand







home |
			news |
			coming soon |
			latest offers |
			specials |
			full machines |
			pcbs & kits |
			merchandise |
			parts |
			wanted |
			about us


(c) 2001-2025 coinopexpress. all rights reserved.








